6 8
WWWWWWWW
WGoo..KW
W..oWoCW
WP.Wo.KW
Wo.o.oCW
WWWWWWWW